...X....
.XX.c...
.......X
...XXX.X
.......X