...X.......................
...........................
.......X...................
...XXX.X...................
.......X...................