...X....
.XX.....
.......X
...XXX.X
.......X